------------------------------------------------------------------------------------------------------------------------------------------------------
------------------------------------------------------------------------------------------------------------------------------------------------------
-------------------#----------------------------------------------------------------------------------------------------------------------------------
-------------------#--------------------------------------------------------------------------------------------------#-------------------------------
-------------------#--%%%%-------------------------------------------------2SS-------------------------------%%%%---U-#-------------------------------
-----------------D%%%%||||-%%%--------g--------------%%-------------------g---------tt---tt--#-----------y---||||-----#K--#--tt--C-----%%%------------
-SS2S-------------||||||||-|||--D-D-%%%%---tt--SSSSC-||--D------SSS-D----SS---------tt---tt--#--tt---tt--%%%%||||---r-#---#--Tt--------|||%%%%--------
------D--SSSDD---D||||||||-|||------||||---tt--------||-----------------------------tt---tt--#--tt---tt--||||||||%%%%%%%--#--tt--------|||||||---rg---
------------------||||||||-|||------||||k--tt------g-||-------------g-----%--%%%%%%%%%%%%%%%%%%%%%%%%%DDD|||||||||||||||DDDDD%%%%%%%---|||||||--%%%%--
-S2SS------------------k---------SS|U|||||||-----rg---------DD---%%|||||||||||||||||||-------g--------g-------|||||||||||||||||||||||||||||----------%
---------D--SSS-----%%%%---tt------|-||||D|C-#--%%%%--SSSSS------|||||||||||||||||||||%%%%---%%%%%%---%%%%%---|||||||||||||||||||||||||||||------F---|
--------------------||||---tt---tt-|-||ttD|--#--||||-------------||||||||||||||||%%%||||||---||||||---|||||---|||||||||||||||||||||||%%%%%%---%%%%---|
%%%%------------g---|k||---tt---tt-|-||tt-|r-#--||||k-----g------%%||||tt|||||||||||||||||---||||||---|||||---|||||||||||||||||||||||||||||---||||---|
||||%%--%%%%%%%---%%||||%%%%%%%%%%%%%%%%%%%%%%%%||||%%%%%%%%%%---||||||Tt|||||||||||||||||---||||||---|||||---|||||||||||||||||||||||||||||---||||---|
||||||--|||||||---||||||||||||||||||||||||||||||||||||||||||||---||%%%%%%|||||||%%%%||||||---||||||---|||||---|||||||||||||||||||||||||||||---||||---|
||||||--|||||||---||||||||||||||||||||||||||||||||||||||||||||---|||||||||||||||||||||||||---||||||---|||||---|||||||||||||||||||||||||||||---||||---|