------------------------------------------------------------------------------------------------------------------------------------------------------
------------------------------------------------------------------------------------------------------------------------------------------------------
------------------------------------------------------------------------------------------------------------------------------------------------------
---------C-------#------------------------------------------------------------------------------#-----------------------------------------------------
-----------------#----------------------%%%%%----------------------------------------------%%---%%%--%%-----------DDDDDD------------------------------
-----------------#----------------#--#--|||||-----DDDDDD--%%---------------------------S---||---|||--||-------------C-----------------USS--------SS---
-SS--------y---%%%%%--DDD--DDD--%%%--%%%|||||-------------||-------------------------------||---|||--k|-S--SS---------g-tt-----------------tt-------SS
------D--%%%%%-|||||------------|||--||||||||--------k----||-----------------ry--C----DD---||---D|%%%%|-----------------Tt-----------------tt---tt----
---------|||||-|||||------------|||--|||||||S----%%%%%----||-SSC----C-------%%%%--SSS------||----||||||-----------------tt---%%%%%%--------tt---tt----
SSSSS--||||||||||||----||||---tt----------%%%%||||%%--D---||----||-------------------|||||||D----------------------||||||-----------------------------
-------||||||||||||----||||---tt----------||||||||||-----%%%%---||-----tt-SSS----SS--|g||||*D--------S---U---------||C|||-----------------C-----------
-------||||||||||||%%%%||||%%%%%%%%%%--%%%||||||||||-----||||---||-----tt-----------S||||||*D-tt--SSS------SSC--%%%||-||tt--#-------S--------D----D---
%%%%---||||||||||||||||||||||||||||||--|||||||||||%%--DDD||||---||-----tt---%%%%%----||||||*D-Tt----------------|||||-||tt--#---#--------------tt-----
||||%%%||||||||||||||||||||||||||||||--|||||||||||||-----||||---%%---%%%%%%%|||||----||||||*--tt------g--------g|||||-||tt--#--##--------------Tt--F--
|||||||||||||||||||||||||||||||||||||--|||||||||||||-----||||---||---||||||||||||%%%%||||||%%%%%%%%%%%---%%%%%%%|||%%%%%%%%%%%%%%---%%%%%%%%%%%%%%%%--
|||||||||||||||||||||||||||||||||||||--|||||||||||XX--XXX||||---||---|||||||||||||||||||||||||||||||||---||||||||||||||||||||||||---||||||||||||||||--