------------------------------------------------------------------------------------------------------------------------------------------------------
------------------------------------------------------------------------------------------------------------------------------------------------------
------------------------------------------------------------------------------------------------------------------------------------------------------
------------------------y-----g--g-----g----g---------------------------------------------------------------------------------------------------------
-------------D-S---CSS%%%%SC%%%%%%%%%%%%%%%%%---SSSC------------------------------------------DDDDDD-------------D----%%%--%%%------------------------
----------------------||||--|||||||||||||||||--------------------------------------------------------------------D----|||--|||-SSSS-------------------
-S2-------------------||||--|||||||||||||||||S2S-------DDDDD------SSSSSSSSS----S2S----U----SS-----k-S2SS-----g---D----|||-g|||--------------%%DDDDDD--
------DDDDD%%%%%----D-||||--|||||||||#|||||||--------------------------------------------------%%%%------S-SSS-----tt-D|%%%%||--------------||--------
-----------|||||------||||--#||||||k|#|||||||----------------S-S---SS--------------------------||||----------------tt--|||||||-tt-------%%%%||DD*-S-S-
-S2SS--------ry-||||||---------------S--S2---||||-|||tt---------Tt-----|||||||||||||||||||||||-----||---||||||||||||||||||||||||||||||---|||||---DDDDD
---------D--%%%%|||tt|-SS2------D------------||||%|||%%%%---%%%%%%%%---|||||||||||||||||||||||-*---||---|||||||||||||||g|||||||||||S||---||D|SSC----||
------------|||||||tt|-----------------------||||||||||||---||||||||---||||||||||||||D%%%||||S-*---||---|#||tt|||tt||SSS2SS||D|||||-||---||D|-------||
%%%%--------|||||||tt|-----g--------%%%%%%---||||||||||||---||||||||---||||||||||SSS|-|||||||--*---#|---|#||tt|||Tt||------||tt||D|-||---||-|----g-F||
||||%%-%%%%%||||%%%%%%%%%%%---%%%---||||||---%%%%||||||||---||||||||---||||||||||--%%D|||||||--*---##---|#||tt|||tt||----g-||tt||-|-||---%%%%%%%%%%%||
||||||-||||||||||||||||||||---|||---||||||---||||||||||||---||||||||---||||%%||||%%||-|||%%%%%%%---%%---%%%%%%%%%%%%%%%%%%%%%%%%%%%%%%---|||||||||||||
||||||-||||||||||||||||||||---|||---||||||---||||||||||||---||||||||---2SS|||||||||||-||||||||||---||---||||||||||||||||||||||||||||||---|||||||||||||