------------------------------------------------------------------------------------------------------------------------------------------------------
------------------------------------------------------------------------------------------------------------------------------------------------------
--------------------------#---------------------------------------------------------------------------------------------------------------------------
--------------------------#---------------------------------------------------------------------------------------------------------------------------
---------------D----------#K--------------------------------------------------------------r--------------------------------------------D--------------
---------------D----------#-------------------S---g-------------------SSS---SS-----DDDDDDS%%%----------%%C--------------------C------------------S---S
-SS--------------------%%%%DD----SS---SS-S--S---SS------tt-------S-SS2S--------SSS--------|||-----tt---||---%%%%--------%%%%---------------%%%%%------
------D--2S2S2SDDDDD-%%||||-----------------------------Tt---tt------------tt----------tt-|||-----tt---||---||||---tt---||||-----%%%---DD%%|||||------
---------------D---C-||||||-------S---------------------tt---tt--------g---Tt----------Tt-|||%%%%%%%%%%||---|k||---tt---||||-----|||-----|||||||------
SSSSS-------U--------------------------------------yk---------------------%%%%-----tt-----tt--------%%%%--U--tt-D-----------------------tt---%%%%%%---
---------D-------SSC---------g-------------------%%%%---tt----------------||||-----Tt-----tt--------||||-----Tt----------g------g-------tt--F||||||%--
---------------------------SSS2S--------tt-------||||---tt---tt-----------||||-----tt-----tt--------||||-----tt-------%%%%%%%---%%%%%%%%%%%%%|||||||--
%%%%-------------------------------tt---tt-------|k||---tt---Tt---%%%---%%||||%%%%%%%%%%%%%%%%%--%%%||||%%%%%%%%%%%---|||||||---||||||||||||||||||||--
||||%%%%%%%%%%-----------r-----g---Tt---tt---%%%%||||%%%%%%%%%%%%%|||---|||||||||||||||||||||||--||||||||||||||||||---|||||||---||||||||||||||||||||--
||||||||||||||---%%--%%---%%%%%%%%%%%%%%%%%%%||||||||||||||||||||||||---|||||||||||||||||||||||--||||||||||||||||||---|||||||---||||||||||||||||||||--
||||||||||||||---||--||---|||||||||||||||||||||||||||||||||||||||||||---|||||||||||||||||||||||--||||||||||||||||||---|||||||---||||||||||||||||||||--