------------------------------------------------------------------------------------------------------------------------------------------------------
------------------------------------------------------------------------------------------------------------------------------------------------------
--------------------#------------------------C--------------------------------------------------------------------------------------------------------
----------------#---#-----------------------U------------------------------------------------------------------------------------------------#--------
---------------##---#-----%%--------------------------g-----C------#---r-k--------r-------2S-------------------------------------SSC-----tt--#--tt----
------------%%%%%---%%%---||------#--%%%%%%-r---G#--%%%%%-*----tt--#--%%%%--S-#--%%%%--SSS----%%%%%%------------tt-D-%%%%----------------Tt--#--tt---%
------------|||||---|||---||%%----%%%||||||%%%%--#--|||||-*----Tt--#K-||||----#--||||---------||||||-------tt---tt---||||------------g---tt--#--tt---|
------D-%%%%|||||---|||---||||----|||||||||||||--#--|||||-*----tt--#--||||----#--||||-----SS--|||||SSS-SS--Tt---tt---||||---%%---%%%%%%%%%%%%%%%%%%%%|
--------||||||||S---|||---||||----|||||||||||||----S|||||%%%%%%%%%%%%%||||%%%%%%%||||%%%%%----|||||------DDDDDDD%%DDDDDDDDDD||---|||||||||||||||||||||
SSSSS------------------------||||--------------tt---tt---------------------------------C------------------------------------g----U--------------------
---------D--U--tt-D------g---|k||------g-------tt---Tt----SS-*-----------------------------C--C-----C---r-k----g----------S---SS-------------%%%%-----
---------------tt---%%%%---D%||||%%%%%%%%%---%%%%%%%%%%%%%%%%*-----------------tt-D----------C---------%%%%--%%%%%---------------------------||||-----
%%%%--------r--tt---||||----||||||||||||||---||||||||||||||||*--tt---tt--------Tt----------------------||||--|||||------------g--------------||||--F--
||||%%%%%%%%%%%%%%%%||||----||||||||||||||---||||||||||||||||*--tt---tt--------tt---%%%%-----r---------|k||k-|||||%----%%%%---%%%%%%--%%%%%%%||||%%%--
||||||||||||||||||||||||----||||||||||||||---||||||||||||||%%%%%%%%%%%%%%%--%%%%%%%%||||---%%%%%%%--%%%||||%%||||||----||||---||||||--||||||||||||||--
||||||||||||||||||||||||----||||||||||||||---||||||||||2SS||||||||||||||||--||||||||||||---|||||||--|||||||||||||||XXXX||||---||||||--||||||||||||||--