------------------------------------------------------------------------------------------------------------------------------------------------------
------------------------------------------------------------------------------------------------------------------------------------------------------
------------------------------------------------------------------------------------------------------------------------------------------------------
------C-----------------------------------------------------------------------------------------------------------------------------------------------
------------------#------------S-%%%--DDDD------------------------------------------------------------------------------------tt--U-#--------SS2S-----
------------------#--------------|||-------------------------------------------------------------------------------------tt---tt----#-----------------
-SC---------------#--------------|||---g---S------------S-------------------------------r----------------------%%%%%%----tt---tt----#-----g------g----
------DDDDD-----%%%%%----------SS2||-%%%%------S------S----tt---------------C----------%%%-S-----------------DD||||||%%%%%%%%%%%%%%%%%---%%%%%%%%%---%
----------------|||||-----G-------||-||||------------------tt---%%%%-------------------|||-----*--%%%%-SSS-----|||||||||||||||||||||||---|||||||||---|
--2SS---------||||||||--------||||---tt||-||--|k||---tt-------------||||-%%%%|||---|||||||-||||---------r-k-#-|SS|||--C*---S----S---------------------
---------D----||||||||%%%%%%%%||||%%%%%%%%%%%%||||%%%%%%%%---%%---%%||||-|||||||---|||||||-||||%%%%-S--%%%%-#-|--||tt--*------U-----C---------g--F%%%%
-------------%||||||||||||||||||||||||||||||||||||||||||||---||---||||||-|||||||---|||||||-||||||||----||||---tt-||Tt--*-----------------%%---%%%%||||
%%%%---------|||||||||||||||||||||||||||||||||||||||||||||---||---||||||-|||||||---|||||||%||||||||----||||---tt-||tt--*-----------------||---||||||||
||||%%--%%%%%|||||||||||||||||||||||||||||||||||||||||||||---||---||||||%||||%||---||||||||||||||||%%%%||||%%%%%%%%%%%%%----%%%%%---%%---||---||||||||
||||||--||||||||||||||||||||||||||||||||||||||||||||||||||---||---||||||||||||||---|||||||||||||||||||||||||||||||||||||----|||||---||---||---||||||||
||||||--||||||||||||||||||||||||||||||||||||||||||||||||||---||---||||||||||||||---|||||||||||||||||||||||||||||||||||||----|||||---||---||---||||||||