------------------------------------------------------------------------------------------------------------------------------------------------------
------------------------------------------------------------------------------------------------------------------------------------------------------
------------------------------------------------#-----------------------------------------------------------------------------------------------------
------------------------------------------------#---------#--------------------------------#----------------------------------------------------------
------------------------------------------------#---------#-----------------DDDDDDD------DDD---DD---SSSS------g-DDDD---%%%%%%-------------------------
-----------------S2SSSSSSSSS--C-----------------#---------#---C----------------------SSS--------------------SSS2SS---S-||||||-------------------------
-SS---------------------------------------%%---%%%%---DDDDDD---------S---------ry--------------------------------------|||||SS2S----------------------
------D%%%%%%%%--D-------------D----------||---||||SS-----D--------------S-S--%%%%--*--tt--S----D----D----r------tt----|tt||--------%%%%%-C-----------
-------||||||||---------------------------SS---||||-------D--%%---%%D---------||||--*--tt--------------D---%%----Tt----|Tt||----g---|||||-------------
SSSSS----------gk---D---U--------------------g--r-----g---Tt--r-----||----tt---|||||---||||||||||||||||---|||||---||||||---||---%%%%--SSSS----tt------
---------D---%%%%---D------tt--SSC---D-%%%%%%%%---%%%%%%%%%%%%%%%---||%%%%%%%%%|||||---||||||||||||||||---|||||---||||||---||---||||----------tt------
-------------||||---tt-----tt----------||||||||---|||||||||||||||---||||||||||||||||---||||||||||||||||---|||||---||||||---||---||||------g---tt-----F
%%%%---------|k||---tt-----tt------g---||||||||---|||||||||||||||---||||||||||||||||---||||||||||||||||---|||||---||||||---||%%%||||%%%%%%%%%%%%%%%%%%
||||%%--%%%%%||||%%%%%%%%%%%%%%%%%%%%%%%%%%%%||---|||||||||||||||---||||||||||||||||---||||||||||||||||---|||||---D|||||---|||||||||||||||||||||||||||
||||||--|||||||||||||||||||||||||||||||||||||||---|||||||||||||||---||||||||||||||||---||||||||||||||||---|||||----|||||---|||||||||||||||||||||||||||
||||||--|||||||||||||||||||||||||||||||||||||||---|||||||||||||||---||||||||||||||||---||||||||||||||||---|||||----|||||---|||||||||||||||||||||||||||